Base -

,-------------------------------------------.                              ,-------------------------------------------.
|  Tab   |   Q  |   D  |   R  |   W  |   B  |                              |   J  |   F  |   U  |   P  |   ;  |  Alt   |
|--------+------+------+------+------+------|                              |------+------+------+------+------+--------|
|Ctrl/Esc|   A  |   S  |   H  |   T  |   G  |                              |   Y  |   N  |   E  |   O  |   I  |Ctrl/Ent|
|--------+------+------+------+------+------+-------------.  ,-------------+------+------+------+------+------+--------|
| LShift |   Z  |   X  |   M  |   C  |   V  |  Gui |1>Func|  |1>Nav |->Num |   K  |   L  |   ,  |   .  |   /  | RShift |
`----------------------+------+------+------+------+------|  |------+------+------+------+------+----------------------'
                       |Rotary|      | Del  |Bksp/ |1>Mods|  |1>Mods|Space/| Del/ | Bksp |Rotary|
                       | Vol  |      |      |Lower |      |  |      |Raise |Arrows|      |PgU/D |
                       `----------------------------------'  `----------------------------------'
                                                \______ ->Adjust ______/

Raise -

,-------------------------------------------.                              ,-------------------------------------------.
|    ~   |   !  |   @  |   #  |   $  |   %  |                              |   ^  |   &  |   *  |   (  |   )  |   :    |
|--------+------+------+------+------+------|                              |------+------+------+------+------+--------|
|    `   |   1  |   2  |   3  |   4  |   5  |                              |   6  |   7  |   8  |   9  |   0  |   ;    |
|--------+------+------+------+------+------+-------------.  ,-------------+------+------+------+------+------+--------|
|        |   :  |      |   -  |   [  |   {  |      |      |  |      |      |   }  |   ]  |   +  |      |      |        |
`----------------------+------+------+------+------+------|  |------+------+------+------+------+----------------------'
                       |      |      |      |      |      |  |      |  \/  |      |      |      |
                       |      |      |      |      |      |  |      |  /\  |      |      |      |
                       `----------------------------------'  `----------------------------------'

Lower -

,-------------------------------------------.                              ,-------------------------------------------.
|        |      |   -  |   _  |      |      |                              |      |      |   +  |   =  |      |        |
|--------+------+------+------+------+------|                              |------+------+------+------+------+--------|
|        |   :  |   [  |   {  |   (  |      |                              |      |   )  |   }  |   ]  |   ;  |        |
|--------+------+------+------+------+------+-------------.  ,-------------+------+------+------+------+------+--------|
|        |      |      |   "  |   \  |      |      |      |  |      |      |      |   |  |   '  |Alt+. |      |        |
`----------------------+------+------+------+------+------|  |------+------+------+------+------+----------------------'
                       |      |      |      |  \/  |      |  |      |      |      |      |      |
                       |      |      |      |  /\  |      |  |      |      |      |      |      |
                       `----------------------------------'  `----------------------------------'

Func -

,-------------------------------------------.                              ,-------------------------------------------.
|        |      |      |      |      |      |                              |      |      |      |      |      |        |
|--------+------+------+------+------+------|                              |------+------+------+------+------+--------|
|        |  F1  |  F2  |  F3  |  F4  |  F5  |                              |  F6  |  F7  |  F8  |  F9  | F10  |        |
|--------+------+------+------+------+------+-------------.  ,-------------+------+------+------+------+------+--------|
|        | F11  | F12  | F13  | F14  | F15  |      |      |  |      |      | F16  | F17  | F18  | F19  | F20  |        |
`----------------------+------+------+------+------+------|  |------+------+------+------+------+----------------------'
                       |      |      |      |      |      |  |      |      |      |      |      |
                       |      |      |      |      |      |  |      |      |      |      |      |
                       `----------------------------------'  `----------------------------------'

Arrows -

,-------------------------------------------.                              ,-------------------------------------------.
|        |Sh+Lft|Sh+Dwn|Sh+Up |Sh+Rt |      |                              |      |Sh+Lft|Sh+Dwn|Sh+Up |Sh+Rt |        |
|--------+------+------+------+------+------|                              |------+------+------+------+------+--------|
|        | Left | Down |  Up  |Right |      |                              |      | Left | Down |  Up  |Right |        |
|--------+------+------+------+------+------+-------------.  ,-------------+------+------+------+------+------+--------|
|        |Ct+Lft|Ct+Dwn|Ct+Up |Ct+Rt |      |      |      |  |      |      |      |Ct+Lft|Ct+Dwn|Ct+Up |Ct+Rt |        |
`----------------------+------+------+------+------+------|  |------+------+------+------+------+----------------------'
                       |      |      |      |      |      |  |      |      |      |      |      |
                       |      |      |      |      |      |  |      |      |      |      |      |
                       `----------------------------------'  `----------------------------------'

Nav -

,-------------------------------------------.                              ,-------------------------------------------.
|        |      |      |      |      |      |                              |      |      |      |      |      |        |
|--------+------+------+------+------+------|                              |------+------+------+------+------+--------|
|        | Home | PgUp | PgDn | End  |      |                              |      | Home | PgUp | PgDn | End  |        |
|--------+------+------+------+------+------+-------------.  ,-------------+------+------+------+------+------+--------|
|        |      |      |      |      |      |      |      |  |      |      |      |      |      |      |      |        |
`----------------------+------+------+------+------+------|  |------+------+------+------+------+----------------------'
                       |      |      |      |      |      |  |      |      |      |      |      |
                       |      |      |      |      |      |  |      |      |      |      |      |
                       `----------------------------------'  `----------------------------------'

Num -

,-------------------------------------------.                              ,-------------------------------------------.
|   (    |   -  |   9  |   8  |   7  |   =  |                              |   =  |   7  |   8  |   9  |   -  |   (    |
|--------+------+------+------+------+------|                              |------+------+------+------+------+--------|
|   *    |   +  |   6  |   5  |   4  |   .  |                              |   .  |   4  |   5  |   6  |   +  |   *    |
|--------+------+------+------+------+------+-------------.  ,-------------+------+------+------+------+------+--------|
|   )    |   /  |   3  |   2  |   1  |   :  |      |      |  |      |->Base|   :  |   1  |   2  |   3  |   /  |   )    |
`----------------------+------+------+------+------+------|  |------+------+------+------+------+----------------------'
                       |      | Del  |   0  |Enter | Bksp |  | Bksp |Enter |   0  | Del  |      |
                       |      |      |      |      |      |  |      |      |      |      |      |
                       `----------------------------------'  `----------------------------------'

LMods -

,-------------------------------------------.                              ,-------------------------------------------.
|        |      |      |      | Alt  |      |                              |      | Alt  |      |      |      |        |
|--------+------+------+------+------+------|                              |------+------+------+------+------+--------|
|        |      |      | Tab  | Ctrl |Gui(M)|                              |Gui(M)| Ctrl |      |      |      |        |
|--------+------+------+------+------+------+-------------.  ,-------------+------+------+------+------+------+--------|
|        |      |      |      | Shift|  Gui |      |      |  |      |      |      | Shift|      |      |      |        |
`----------------------+------+------+------+------+------|  |------+------+------+------+------+----------------------'
                       |      |      |      |      |  \/  |  |  Esc |Enter |      |      |      |
                       |      |      |      |      |  /\  |  |      |      |      |      |      |
                       `----------------------------------'  `----------------------------------'

RMods -

,-------------------------------------------.                              ,-------------------------------------------.
|        |      |      |      | Alt  |      |                              |      | Alt  |      |      |      |        |
|--------+------+------+------+------+------|                              |------+------+------+------+------+--------|
|        |      |      |      | Ctrl |Gui(M)|                              |Gui(M)| Ctrl | Tab  |      |      |        |
|--------+------+------+------+------+------+-------------.  ,-------------+------+------+------+------+------+--------|
|        |      |      |      | Shift|      |      |      |  |      |      | Gui  | Shift|      |      |      |        |
`----------------------+------+------+------+------+------|  |------+------+------+------+------+----------------------'
                       |      |      |      | Enter|  Esc |  |  \/  |      |      |      |      |
                       |      |      |      |      |      |  |  /\  |      |      |      |      |
                       `----------------------------------'  `----------------------------------'

Adjust -

,-------------------------------------------.                              ,-------------------------------------------.
|        |      |      |      |      |      |                              |      |      |      |      |      |        |
|--------+------+------+------+------+------|                              |------+------+------+------+------+--------|
|        |      |      |      |      |      |                              |      |      |      |      |      |        |
|--------+------+------+------+------+------+-------------.  ,-------------+------+------+------+------+------+--------|
|        |      |      |      |      |      |      |      |  |      |      |      |      |      |      |      |        |
`----------------------+------+------+------+------+------|  |------+------+------+------+------+----------------------'
                       |      |      |      |      |      |  |      |      |      |      |      |
                       |      |      |      |      |      |  |      |      |      |      |      |
                       `----------------------------------'  `----------------------------------'
